#########
#..*...E#
#..##T..#
#.*.....#
#########
