#########
#P...*.E#
#.##....#
#T......#
#########
